11111111111111111111,
10000010000000000001,
10000011111000010001,
10000010000000010001,
10000010000000010001,
10000000000001111001,
10000000000000000001,
11111100000100000001,
10100000000100000001,
10100000000100000001,
10001000000101111111,
10001 00000100000001,
11111000000111111101,
10000000000100000001,
10000000000100000001,
10000000000000000001,
11111000010000001111,
10001000011000111001,
10000000010000000001,
11111111111111111111,